0,0,0,0,0
0,3,9,1,0
0,9,9,1,0
0,1,9,9,0
0,1,9,2,0
0,0,0,0,0
